1111111111111111
1C00000000000001
10010000C0000001
10P1000000000001
1001000000C00001
1001000000000001
1111111111111111