1111111111
1000000001
1001000001
10P1000001
1111111111