1111111111111111
1C0001000001C0E1
10010111C1010001
10P100C101010001
1001000101C00001
1001000001000001
1111111111111111